1111111111111
1000000010001
1000P01000001
1000000000001
1111111111111
