1111111111111
10000000100C1
10C0P01000001
100000E000001
1111111111111
