1111111111111
10C0000010001
1000P01000001
100000C000001
1111111111111
