1111111111111
10000000000C1
10C0000000001
1000P0E000001
1111111111111
