1111111111111111111111111111111111111111111111111111111111111111111111111111111111111111111111111111111111111111111
1000000000000000000000000000000000000000000000000000000000000000000000000000000000000000000000000000000000000000001
1000000000000000000000000000000000000000000000000000000000000000000000000000000000000000000000000000000000000000001
1000000000000000000000000000000000000000000000000000000000000000000000000000000000000000000000000000000000000000001
1000000000000000000000000000000000000000000000000000000000000000000000000000000000000000000000000000000000000000001
1000000000000000000000000000000000000000000000000000000000000000000000000000000000000000000000000000000000000000001
1000000000000000000P000000C000000000E000000000000000000000000000000000000000000000000000000000000000000000000000001
1000000000000000000000000000000000000000000000000000000000000000000000000000000000000000000000000000000000000000001
1000000000000000000000000000000000000000000000000000000000000000000000000000000000000000000000000000000000000000001
1000000000000000000100000000000000000000000000000000000000000000000000000000000000000000000000000000000000000000001
1000000000000000000100000000000000000000000000000000000000011111111111111111111111111000000000000000000000000000001
1000000000000000000100000000000000000000000000000000000000000000000000000000000000000000000000000000000000000000001
1000000000000000000100000000000000000000000000000000000000000000000000000000000000000000000000000000000000000000001
1000000000000000000100000000000000000000000000000000000000000000000000000000000000000000000000000000000000000000001
1000000000000000000100000000000000000000000000000000000000000000000000000000000000000000000111111100000000000000001
1000000000000000000100000000000000000000000000000000000000000000000000000000000000000000000000000000000000000000001
1000000000000000000100000000000000000000000000011111111111111111111111111111111110000000000000000000000000000000001
1000000000000000000000000000000000000000000000000000000000000000000000000000000000000000000000000000000000000000001
1000000000000000000000000000000000000000000000000000000000000000000000000000000000000000000000000000000000000000001
1000000000000000000000000000000000000000000000000000000000000000000000000000000000000000000000000000000000000000001
1000000000000000000000000000000000000000000000000000000000000000000000000000000000000000000000000000000000000000001
1000000000000000000000000000000000000000000000000000000000000000000000000000000000000000000000000000000000000000001
1111111111111111111111111111111111111111111111111111111111111111111111111111111111111111111111111111111111111111111
